R    1920 1080 
NO ./textures/wood.xpm

SO ./textures/bluestone.xpm
WE ./textures/redbrick.xpm

EA ./textures/greystone.xpm
S ./textures/pillar.xpm
F    80,  80,80 

C 0, 255,     255


        1111111111111111111111111
        1000000000111000020000001
        1011020000111000000000001
        1001000000000000000000201
111111111011000001110000000000001
100000000011000001110111100011111
11110111111111011100000010001
11110111111111011101010010001
1102000011010101110000001E001
10000000000000001100020010001
10000020000000001101010010001
1100000111010101111101111000111
10110111 1110101 101111010001
11111111 1111111 111111111111